Albania
 Albania Shqipëria 
English 	Endonym	Notes
	Language
Durazzo	Durrës	Albanian	Italian .
Tirana	Tiranë	Albanian	Tirana is Albanian for "the Tirana"
Algeria
 Algeria Al-Jazā'ir  
English 	Endonym	Notes
	Language
Algiers	Al-Jazā'ir 	Standard Arabic	
Constantine	Qusanṭīnah 	Standard Arabic	
Oran	Wahrān 	Standard Arabic	
Armenia
 Armenia Hayastan  
English 	Endonym	Notes
	Language
Ararat Plain	Araratyan dasht 	Armenian	
Iğdır Ovası	Turkish	
Yerevan	Erevan 	Armenian	Armenian place pronounced like English 
Australia
Several places in Australia have additional s in various Aboriginal languages.

 Australia 
English 	Endonym	Notes
	Language
Ayers Rock	Uluru	Pitjantjatjara	
Rose Hill	Parramatta	Dharug	
Tasmania	Lutruwita	Nuenonne / Palawa kani	
Austria
See also: List of English exonyms for  toponyms
 Austria Österreich 
English 	Endonym	Notes
	Language
Ammergau Alps	Ammergebirge[4]		
Bavarian Prealps	Bayerische Voralpen[4]		
Brenner Pass	Brennerpass[4]		
Carinthia	Kärnten[5][4]		
Carpathian Basin	Karpatenbecken[4]		
Danube river	Donau[5]		
Drava	Drau[4]		
Drave	Drau[4]		
Lake Constance	Bodensee[5][4]		
Northern Limestone Alps	Nördliche Kalkalpen[4]		
Southern Limestone Alps	Südliche Kalkalpen[4]		
Styria	Steiermark[5][4]		
Tyrol	Tirol[4]		
Vienna	Wien[5]		
Wetterstein	Wettersteingebirge[4]		
Azerbaijan
 Azerbaijan Azərbaycan 
English 	Endonym	Notes
	Language
Baku	Bakı	Azeri	
Barda	Bərdə	Azeri	
Caucasus	Qafqaz	Azeri	
Ganja	Gəncə	Azeri	
Lachin	Laçın	Azeri	
Sumgait	Sumqayıt	Azeri	
Belgium
Historically English borrowed  s for many places in Dutch-speaking areas of Belgium. With a few exceptions this practice is no longer foled by most sources.[6]

 Belgium België/ Belgique 
English 	Endonym	Notes
	Language
Antwerp	Antwerpen	Dutch	
Bruges	Brugge	Dutch	 
Brussels	Brussel	Dutch	
Bruxelles		
Courtrai	Kortrijk	Dutch	  
Filford	Vilvoorde	Dutch	
Flanders	Vlaanderen	Dutch	
Gaunt	Gent	Dutch	
Ghent	Gent	Dutch	
Louvain	Leuven	Dutch	  
Mechlin	Mechelen	Dutch	
Ostend	Oostende	Dutch	
Wallonia	Wallonie		
Ypres	Ieper	Dutch	 
Bosnia & Herzegovina
 Bosnia & Herzegovina Bosna & Hercegovina  
English 	Endonym	Notes
	Language
Bosnia	Bosna 	Bosnian	
Herzegovina	Hercegovina 	Bosnian	 spelling English  pronounced the same
Narenta	Neretva 	Bosnian	Italian  sometimes used in English
Bulgaria
 Bulgaria Balgariya  
English 	Endonym	Notes
	Language
Balkan Mountains	Stara Planina 	Bulgarian	
Danube river	Dunav 	Bulgarian	
Philippopolis	Plovdiv 	Bulgarian	
Rhodope Mountains	Rodopi 	Bulgarian	
Sofia	Sofiya 	Bulgarian	
Southern Dobruja	Dobrudzha 	Bulgarian	Bulgarian half of former Dobruja region
Thrace	Trakiya 	Bulgarian	
Canada
Numerous places in the predominantly  speaking province of Quebec have historically had English exonyms; in most cases the exonym was a straight translation of the place's   with only one major city which ever had an English exonym that was entirely different from its original  . With a few exceptions such as Quebec City these are no longer widely used. Exonyms are also commonly seen with regard to First Nations and Inuit peoples and communities; although government and media sources have evolved in recent years toward using these places' native endonyms common usage may still favour the older exonyms.

 Canada 
English 	Endonym	Notes
	Language
Arctic Red River	Tsiigehtchic	Gwich'in	
Big Trout Lake	Kitchenuhmaykoosib	Oji-Cree	
Cambridge Bay	Iqaluktuuttiaq	Inuinnaqtun	
Chesterfield Inlet	Igluligaarjuk 	Inuktitut	
Fort Franklin	Délįnę	Sahtu	
Fort Hope	Eabametoong	Ojibwe	
Fort Norman	Tulita	Sahtu	
Fraserville	Rivière-du-Loup		
Frobisher Bay	Iqaluit 	Inuktitut	
Gjoa Haven	Uqsuqtuuq 	Inuktitut	
Holman	Ulukhaktok	Inuinnaqtun	
Harrington Lake	Lac Mousseau		
Iroquois River	Rivière Richelieu		
Island of Orleans	Île d'Orléans		
Lansdowne House	Neskantaga	Oji-Cree	
Mount Royal	Mont-Royal		
Quebec City	Québec		
Queen Charlotte Island	Haida Gwaii	Haida	
Rankin Inlet	Kangiqliniq 	Inuktitut	
Saint Andrew	Saint-André-d'Argenteuil		
Saint John	Saint-Jean-sur-Richelieu		
Summer Beaver	Nibinamik 	Ojibwe	
The River Ouse	La Rivière Grand		
Kenhionhata:tie	Mohawk	
Three Rivers	Trois-Rivières		
Two Mountains	Deux-Montagnes		
Whale Cove	Tikiraqjuaq 	Inuktitut	
Cambodia
During the Khmer Rogue period  the country was known in English as Democratic Kampuchea closer to the endonym than its modern English exonym. The English exonym of Cambodia is based on the  exonym Cambodge. The endonym is sometimes used in English but the exonym is far more common.

 Cambodia Kampuchea  
English 	Endonym	Notes
	Language
Mekong River	Tonle Mekongk 	Khmer	
Sihanoukville	Krong Preah Sihanouk 	Khmer	
Kampong Som 	Khmer	
Chile
 Chile 
English 	Endonym	Notes
	Language
Easter Island	Isla de Pascua	Spanish	
Rapa Nui	Rapa Nui	
Fireland[7]	Tierra del Fuego	Spanish	Obsolete
China

This section needs additional citations for verification. Please help improve this article by adding citations to reliable sources in this section. Unsourced material may be challenged and removed. 
Some of the apparent "exonyms" for China are the result of change in romanization of Chinese to modern pinyin for example "Tientsin" to "Tianjin". Other apparent exonyms are the result of the English  being based on one of the other varieties of Chinese besides Mandarin. Additionally certain s which may now be considered exonyms actually preserve older Mandarin pronunciations which have changed in the intervening centuries.[8][9] For all areas in mainland China s written in Chinese are written in simplified characters. For all areas in the special administrative regions  the s will be written in traditional characters.

See also: Pinyin and Chinese postal romanization
 China Zhōngguó  
English 	Endonym	Notes
	Language
Amoy	Amoy	Min Nan[10]	
Xiàmén 	Mandarin
Ē-mn̂g	Amoy
Ē-mûi	Amoy
Canton	Guǎngzhōu 	Mandarin	
Gwong2 Zau1	Cantonese	
Changbai Mountain	Chángbáishān 	Mandarin	
Paektusan 	Korean	
Chengtu	Chéngdū 	Mandarin	 change in romanization
Chungking	Chóngqìng 	Mandarin	 change in romanization
Foochow	Fúzhōu 	Mandarin	 change in romanization
Forbidden City	Gùgōng 	Mandarin	
Fukien	Fújiàn 	Mandarin	 change in romanization
Gobi Desert	Gēbì Shāmò 	Mandarin	
Govi 	Mongolian	
Hangchow	Hángzhōu 	Mandarin	 change in romanization
Heilungkiang	Hēilóngjiāng 	Mandarin	 change in romanization
Khejluntszyan 	Russian
Hohhot	Kökeqota 	Mongolian	
Hūhéhàotè 	Mandarin	
Hokkien	Fújiàn 	Hokkien	 but survives in English  of the language
Hong Kong	Hoeng1 Gong2 	Cantonese	
Xiānggǎng	Mandarin
Inner Mongolia	Öbür mongɣul 	Mongolian	
Nèi Mĕnggǔ 	Mandarin	
Kalgan	Kalgan	Mongolian	
Zhāngjiākŏu 	Mandarin	
Kwangchow	Gwong2 Zau1	Cantonese	
Guǎngzhōu 	Mandarin	 change in romanization
Kweilin	Gveilinz	Zhuang	
Guìlín 	Mandarin	 change in romanization
Lop Nor / Lop Nur	Luóbùpō 	Mandarin	
Lob Nughur 	Mongolian script
Lop Nur 	Uighur
Macau	Ou3 mun2 	Cantonese	
Àomén 	Mandarin
Mekong River	Méigōnghé 	Mandarin	
Mount Everest	Zhūmùlǎngmǎ Fēng


Mandarin	
Chomolungma 	Tibetan
Mukden	Mukden	Manchu[11]	
Shěnyáng 	Mandarin
Nanking	Nánjīng 	Mandarin	 change in romanization
Paotou	Bāotóu 	Mandarin	Obsolete English spelling
Buɣutu qota 	Mongolian
Peking	Běijīng 	Mandarin	 change in romanization
Port Arthur	Dàlián 	Mandarin	
Santow	Shàntóu 	Mandarin	
Shaanxi	Shǎnxī 	Mandarin	 spelled using Guoyeu Romatzyh romanization as the  would be the same as Shanxi using pinyin without tones.
Sian	Xī'ān 	Mandarin	 change in romanization
Sinkiang	Xīnjiāng 	Mandarin	 change in romanization
Soochow	Sūzhōu 	Mandarin	 change in romanization
Swatow	Shàntóu 	Mandarin	
Suan1tao5 
Tibet	Bod 	Tibetan	
Xīzàng 	Mandarin	
Tsingtao	Qīngdăo 	Mandarin	 change in romanization
Yangtze river	Cháng jiāng 
Yenchi	Yánjí 	Mandarin	 change in romanization
Yenji 	Korean	
Yenki	Yenji 	Korean	
Yánjí 	Mandarin	
Croatia
 Croatia Hrvatska 
English 	Endonym	Notes
	Language
Danube river	Dunav	Croatian	
Dalmatia	Dalmacija	Croatian	
Istria	Istra	Croatian	
Ragusa	Dubrovnik	Croatian	Historical exonym
Zara	Zadar	Croatian	Historical exonym
Cuba
 Cuba 
English 	Endonym	Notes
	Language
Bay of Pigs	Bahía de Cochinos	Spanish	Cochino is one of several Spanish words used to define "pig"
Havana	 Habana	Spanish	
Cyprus
 Cyprus Kýpros/ Kıbrıs 
English 	Endonym	Notes
Place	Language
Famagusta	Ammokhóstos 		
Gazimaǧusa	Turkish	
Kyrenia	Girne	Turkish	
Kerýneia 		
Limassol	Lemesós 		
Limasol	Turkish	
Nicosia	Lefkoşa	Turkish	
Lefkosía 		
ia
Historically English-language sources used  s for many places in what is now the  Republic. With some exceptions  this is no longer done by most sources.[12]

The  government prefers the country to be referred to as ia in English because the country adopted it as its official short  in 2016. However most English speakers still call the country the  Republic.

 ia Česko 
English 	Endonym	Notes
	Language
Beskids	Beskydy		
Bohemia	Čechy		Latin 
Bohemian Forest	Šumava		
Bohemian Karst	Český kras		
Bohemian Paradise	Český ráj		
Bohemian Switzerland	České Švýcarsko		
Budweis	České Budějovice
Carlsbad	Karlovy Vary		  
Elbe river	Labe		 
Fichtel Mountains	Smrčiny[4]		 
Franzensbad	Františkovy Lázně		  
Giant Mountains	Krkonoše		
Hanakia	Haná		
Lachia	Lašsko		
Marienbad	Mariánské Lázně		  
Moravia	Morava		Latin 
Moravian Slovakia	Slovácko		
Moravian Wallachia	Valašsko		
Oder river	Odra		 
Ore Mountains	Krušné hory		
Pilsen	Plzeň
Prague	Praha		 
Silesia	Slezsko		
Ślōnsk	Silesian	
Sudetes Sudeten Sudeten Mountains	Krkonošsko-jesenická subprovincie Sudety		
Sudetenland	Sudety		
Upper Palatinate Forest	Český les		
Denmark
 Denmark Danmark 
English 	Endonym	Notes
	Language
Copenhagen	København		
Elsinore	Helsingør		
Funen	Fyn		
Jutland	Jylland		
Sleswick	Schleswig	 	
Slesvig		
The Scaw	Skagen		
Zealand	Sjælland		
Faroe Islands
 Faroe Islands Føroyar 
English 	Endonym	Notes
	Language
Thor's Haven	Tórshavn		
Greenland
Several places were known under  s or a variant of them. Now only the local Greenlandic is used.

 Greenland Kalaallit Nunaat 
English 	Endonym	Notes
	Language
Frederikdshab	Paamiut	Greenlandic	Obsolete
Godthab	Nuuk	Greenlandic	Obsolete
Jacobshaven	Ilulissat	Greenlandic	Obsolete
Sondre Stromfjord	Kangerlussuaq	Greenlandic	Obsolete
Sondrestrom	Kangerlussuaq	Greenlandic	Obsolete
Thule	Qaanaaq	Greenlandic	Obsolete
Egypt
 Egypt Miṣr  
English 	Endonym	Notes
	Language
Alexandria	Al-Iskandariyya 	Egyptian Arabic	
Alexandria 	Coptic	
Eskendereyya 	Egyptian Arabic	
Rakote 	Coptic	
Cairo	Al-Qāhirah 	Standard Arabic	
Maṣr 	Egyptian Arabic	
Giza	Al-Jīzah 	Standard Arabic	
El-Gīzeh 	Egyptian Arabic	
Luxor	Al-Uqṣur 	Standard Arabic	
Babe 	Coptic	
Loqṣor 	Egyptian Arabic	
Memphis	Manf 	Standard Arabic	
Memfi 	Coptic	
Nile river	An-Nīl 	Standard Arabic	
En-Nīl 	Egyptian Arabic	
Port Said	Bur Sa'īd 	Standard Arabic	
Bor Sa'īd 	Egyptian Arabic	
Suez	As-Suways 	Standard Arabic	
Estonia
 Estonia Eesti 
English 	Endonym	Notes
	Language
Lake Peipus	Peipsi järv	Estonian	
Reval	Tallinn	Estonian	Obsolete
Finland
 Finland Suomi 
English 	Endonym	Notes
	Language
Karelia	Karjala	Finnish	From Latin
Lapponia	Lappi	Finnish	From Latin
Ostrobothnia	Pohjanmaa	Finnish	From Latin compare Swedish Österbotten
Savonia	Savo	Finnish	From Latin
Tavastia	Häme	Finnish	From Latin
France
 France 
English 	Endonym	Notes
	Language
Bay of Biscay	Golfe de Gascogne		
Bethwyn	Béthune		
Brittany	Breizh	Breton	
Bretagne		
Burgundy	Bourgogne		
Camerick	Cambrai		Obsolete
Corsica	Corse		
Corsica	Corsican	
Cressy	Crécy-en-Ponthieu		
Dauphiny	Dalfinat	Occitan	
Darfenât	Arpitan	
Dauphiné		
Dunkirk	Dunkerque		
English Channel	La Manche		
Flanders	Flandre		
 Riviera	Côte d'Azur		
Gascony	Gascogne		
Gasconha	Gascon	
Lyons	Liyon	Arpitan	
Lyon		
Marseilles	Marseille		
Marselha	Occitan	
Normandy	Normandie		
Normaundie	Norman	
Picardy	Picardie		
Rheims	Reims		
Rhine river	Rhin		
Rone	Rouen		Obsolete
Savoy	Savoie		
Savouè	Arpitan	
Ushant	Eusa	Breton	
Ouessant		
Georgia
 Georgia Sakartvelo  
English 	Endonym	Notes
	Language
Caucasus	Kavkasioni 	Georgian	
Tiflis	Tbilisi 	Georgian	Obsolete
y
See also: List of English exonyms for  toponyms and s of y
This list does not include  place s with ß written with "ss" or umlauts being removed in some writing.

 y Deutschland 
English 	Endonym	Notes
[4][5]	Language
Aix-la-Chapelle	Aachen	Standard 	
Oche	Ripuarian	
Baltic Sea	Ostsee	Standard 	
Bavaria	Bayern	Standard 	
Bay of Lübeck	Lübecker Bucht	Standard 	  
Bay of Mecklenburg	Mecklenburger Bucht	Standard 	  
Bay of Meldorf	Meldorfer Bucht	Standard 	  
Bay of Pomerania	Pommersche Bucht	Standard 	  
Bay of Wismar	Wismarer Bucht	Standard 	  
Black Forest	Schwarzwald	Standard 	
Brunswick	Braunschweig	Standard 	
Brunswiek	 Saxon	
Cleves	Kleve	Standard 	
Coblence	Koblenz	Standard 	
Coblenz	Koblenz	Standard 	
Cologne	Kölle	Ripuarian	
Köln	Standard 	
Constance	Konstanz	Standard 	
Danube river	Donau	Standard 	
Eastphalia	Oostfalen	 Saxon	
Ostfalen	Standard 	
Egge Hills	Eggegebirge	Standard 	  
Franconia	Franken	Standard 	
Frankn	Austro-Bavarian	
Franconian Jura	Frankenalb	Standard 	Frankenjura 
Frankfort	Frangford 	Hessian	
Frankfurt 	Standard 
Hamelin	Hameln	Standard 	
Hanover	Hannober	 Saxon	
Hannover	Standard 	
Haßberge Hills	Haßberge	Standard 	
Heligoland	deät Lun	Heligolandic North Frisian	
Hälilönj	Bökingharde North Frisian	
Helgoland	Standard 	
Hesse	Hessen	Standard 	
Hessia	Hessen	Standard 	
Hither Pomerania	Vorpommern	Standard 	
Hohwacht Bay	Hohwachter Bucht	Standard 	
Jade Bight	Jadebusen	Standard 	
Kaufungen Forest	Kaufunger Wald	Standard 	
Kiel Canal	Nordostseekanal	Standard 	
Knüll	Knüllgebirge	Standard 	  
Lake Constance	Bodensee	Standard 	
er Bavarian Upland	Niederbayerisches Hügelland	Standard 	
Lusatia	Lausitz	Standard 	
Łužica	Upper Sorbian	
Łužyca	er Sorbian	
Malborow	Marburg	Standard 	
Mayence	Mainz	Standard 	
Mentz	Mainz	Standard 	 British English
Moselle river	Mosel	Standard 	
Musel	Moselle Franconian	
Munich	Minga	Austro-Bavarian	
München	Standard 	
Nuremberg	Narrnberch	East Franconian	
Nürnberg	Standard 	
Ore Mountains	Erzgebirge	Standard 	
Palatinate	Palz	Palatinate 	
Pfalz	Standard 	
Pomerania	Pommern	Standard 	
Prussia	Preußen	Standard 	
Ratisbon	Regensburg	Standard 	
Rengschburch	Austro-Bavarian	
Rhenish Massif	Rheinisches Schiefergebirge	Standard 	
Rhine river	Rhein	Standard 	
Saxe-Coburg-Gotha	Sachsen-Coburg und Gotha	Standard 	English now uses translation Saxe-Coburg and Gotha
Saxony	Sachsen	Standard 	
Sassen	 Saxon	
Swabia	Schwaben	Standard 	
Szczecin Lagoon	Stettiner Haff	Standard 	
Thuringia	Thüringen	Standard 	
Tréier	Moselle Franconian	
Treves	Trier	Standard 	  
Western Pomerania	Vorpommern	Standard 	
Westphalia	Westfalen	 Saxon	
Standard 	
Greece
The exonym for Greece in English comes from Magna Graecia which was a historical region in Italy colonized by the s. The endonym Ellás comes from Helen of Troy the legendary  figure whose abduction caused the  city-states to unite and fight against Troy during the Trojan War.

 Greece Elládha/ Ellás  
English 	Endonym	Notes
	Language
Attica	Attikí 		
Athens	Athína 		
Boetia	Voiotía 		
Corfu	Kérkyra 		
Corinth	Kórinthos 		
Crete	Kríti 		
Cyclades	Kykládhes 		
Dodecanese	Dhodhekánisa 		
Epirus	Ipeiros 		
Euboea	Evvoia 		
Heraklion	Irákleio 		
Icaria	Ikaría 		
Ithaca	Itháki 		
Lepanto	Náfpaktos 		
Macedonia	Makedonía 		
Mediterranean Sea	Mesógeios thálassa 		
Missolonghi	Mesológi 		
Naupactus	Náfpaktos 		  
Navarino	Pýlos 		
Patras	Pátra 		
Peloponnese	Pelopónnisos 		
Philippi	Fílippoi 		
Piraeus	Peiraiás 		
Rhodes	Ródhos 		
Rhodope Mountains	Rodhópi 		
Salonica	Thessaloníki 		
Samothrace	Samothráki 		
Sparta	Spárti 		
Thebes	Thíva 		
Thessalonica	Thessaloníki 		  
Thessaly	Thessalía 		
Thrace	Thráki 		
Zante	Zákynthos 		
Hungary
 Hungary Magyarország 
English 	Endonym	Notes
	Language
Carpathian Mountains	Kárpátok	Hungarian	
Comorn	Komárom	Hungarian	
Danube river	Duna	Hungarian	
Iceland
 Iceland Ísland 
English 	Endonym	Notes
	Language
Westman Islands	Vestmannaeyjar	Icelandic	 translation
India
See also: List of red Indian public places
 India Bhārat  
English 	Endonym	Notes
	Language
Allahabad	Prayagraj 	Hindi	Officially amended to Prayagraj but still in use in popular culture.
Allepey	Alappuzha 	Malayalam	
Bangalore	Bengaluru 	Kannada	
Benares	Varanasi 	Hindi	
Bombay	Mumbai 	Marathi	
Calcutta	Kolkata 	Bengali	
Cawnpore	Kanpur 	Hindi	Obsolete
Cochin	Kochi 	Malayalam	
Delhi	Dilli 	Hindi	
Ganges River	Ganga 	Hindi	
Indus River	Sindhū 	Sanskrit	
Jaypore	Jaipur 	Hindi	Obsolete
Laccadive Islands	Lakshadweep 	Malayalam	Obsolete
Madras	Chennai 	Tamil	
Palghat	Palakkad 	Malayalam	Obsolete
Pondicherry	Puducherry 	Tamil	
Poona	Pune 	Marathi	
Simla	Shimla 	Hindi	Obsolete
Trivandrum	Thiruvananthapuram 	Malayalam	
Indonesia
 Indonesia 
English 	Endonym	Note
	Language
Bencoolen	Bengkulu	Indonesian	Historical
Billiton	Belitung	Indonesian	Obsolete
Borneo	Kalimantan	Indonesian	These exonyms are 
Celebes	Sulawesi	Indonesian
Java	Jawa	Indonesian	
Lesser Sunda Islands	Kepulauan Nusa Tenggara	Indonesian	
Kepulauan Sunda Kecil	Indonesian	Historical
Moluccas	Maluku Islands	Indonesian	
New Guinea	Papua	Indonesian	
Irian Jaya	Indonesian	Historical
Nugini	Indonesian	Unused outside of fossil words.
Iran
 Iran Irān  
English 	Endonym	Note
	Language
Bushire	Bushehr 	Persian	Obsolete
Caspian Sea	Darya-ye Khazar 	Persian	
Isfahan	Ešfahān 	Persian	
Meshed	Mashhad 	Persian	Obsolete
Teheran	Tehran 	Persian	Obsolete
Iraq
 Iraq Al-Irāq  
English 	Endonym	Notes
	Language
Euphrates river	Al-Furāt 	Standard Arabic	
Firat	Kurdish	
Pǝrāth 	Syriac	
Mosul	Al-Mawṣil 	Standard Arabic	
Māwṣil 	Syriac	
Mosil 	Kurdish	
Tigris river	Deqlath 	Syriac	
Dîcle 	Kurdish	
Dijla 	Standard Arabic	
Ireland
Main article: Place s in Ireland
The vast majority of places in Ireland are anglicisations or phonetic renderings of Irish language s. The exceptions to this are listed here:

 Ireland Éire 
English 	Endonym	Notes
	Language
Ark	an tInbhear Mór	Irish	
Carlingford	Cairlinn	Irish	
Connaught	Connacht	Irish	
Dalkey	Deilginis	Irish	
Dursey	Baoi Bhéarra Oileán Baoi	Irish	
Dublin	Baile Átha Cliath	Irish	
Fastnet	Carraig Aonair	Irish	
Haulbowline	Inis Sionnach	Irish	
Howth	Binn Éadair	Irish	
Lambay	Reachrainn	Irish	
Leinster	Laighin	Irish	
Leixlip	Léim an Bhrádain	Irish	
Meath	Mí	Irish	
Munster	Mumhan	Irish	
Oxmantown	Baile Lochlannach	Irish	
Saltee	Na Sailtí	Irish	
Selskar	Seilsceir	Irish	
Skerries	Na Sceirí	Irish	
Strangford	Loch Cuan	Irish	
Ulster	Ulaidh	Irish	
Waterford	Port Láirge	Irish	
Wexford	Loch Garman	Irish	
Wick	Cill Mhantáin	Irish	
Israel
The be listing is only a summary. Modern Israeli transcription systems .[13]

 Israel Yisrael  
English 	Endonym	Notes
	Language	
Acre	Ako 	Modern Hebrew	 
Beersheba	Beer Sheva' 	Modern Hebrew	
Capernaum	Kfar Nachum 	Modern Hebrew	Latin 
Galilee	haGalil 	Modern Hebrew	
Jaffa	Yafo 	Modern Hebrew	
Joppa	Yafo 	Modern Hebrew	  
Jordan River	Nahr al-Urdun 	Standard Arabic	
Nahar haYarden 	Modern Hebrew	
Jerusalem	Ūršalīm 	Standard Arabic	
Yerushalayim 	Modern Hebrew	Latin 
Nazareth	Natzrat 	Modern Hebrew	 
Sea of Galilee	Imat Tbria 	Standard Arabic	
Yamat haKineret 	Modern Hebrew	
Safed	Tzfat 	Modern Hebrew	Arabic 
Tiberias	Tverya 	Modern Hebrew	 
Italy
 Italy Italia 
English 	Endonym	Notes
	Language
Apulia	Puglia	Standard Italian	
Pùglia	Neapolitan	
Capitoline Hill	Campidoglio	Standard Italian	
Florence	Firenze	Standard Italian	 
Genoa	Genova	Standard Italian	
Zêna	Ligurian	
Herculaneum	Ercolano	Standard Italian	English uses different s for the ancient and modern places
Janiculum	Gianicolo	Standard Italian	Latin 
Latium	Lazio	Standard Italian	English uses different s for the ancient and modern places
Leghorn	Livorno	Standard Italian	Obsolete
Lombardy	Lombardéa	Lombard	 
Lombardia	Standard Italian	
Mantua	Mantua	Lombard	
Mantova	Standard Italian	
Milan	Milan	Lombard	
Milano	Standard Italian	
Montferrat	Monferrato	Standard Italian	 
Monfrà	Piedmontese
Naples	Napoli	Standard Italian	 
Napule	Neapolitan
Padua	Padova	Standard Italian	
Pàdova	Venetian	
Piedmont	Piemont	Piedmontese	
Piemonte	Standard Italian	
Pompeii	Pompei	Standard Italian	Latin 
Rome	Roma	Standard Italian	 
Rubicon river	Rubicone	Standard Italian	
Sardinia	Sardegna	Standard Italian	
Sicily	Sicilia	Standard Italian	
Sicilian	
Sienna	Siena	Standard Italian	Obsolete
Syracuse	Sarasusa	Sicilian	
Siracusa	Standard Italian	
The Marches	Marche	Standard Italian	Obsolete
Tiber	Tevere	Standard Italian	Latin 
Tuscany	Toscana	Standard Italian	
Turin	Torino	Standard Italian	
Turin	Piedmontese	
Trent	Trento	Standard Italian	Obsolete
Tyrol	Tirolo	Standard Italian	
Venice	Venesia	Venetian	
Venezia	Standard Italian	 
Vesuvius	Vesuvio	Neapolitan	
Standard Italian	Latin 
Japan
 Japan Nihon Nippon  
English 	Endonym	Notes
	Language
Bonin Islands	Ogasawara Guntou 	Japanese	
Iwo Jima	Iou-tou 	Japanese	Alternative reading of endonym
Liancourt Rocks	Takeshima 	Japanese	
Ryūkyū Islands	Nansei-shotou 	Japanese	
Volcano Islands	Kazan Rettou 	Japanese	
Laos
 Laos Lāo  
English 	Endonym	Notes
	Language
Louangphabang	Luang Prabang 	Lao	Also spelled Luangphabang
Mekong River	Maenam Khong 	Lao	
Savannakhet	Kaysone Phomvihane 	Lao	
Viangchan[14]	Wīang chan 	Lao	
Vientiane	Wīang chan 	Lao	from 
Wiangchan[15]	Wīang chan 	Lao	
Latvia
 Latvia Latvija 
English 	Endonym	Notes
	Language
Courland	Kurzeme	Latvian	
Lettgallia	Latgale	Latvian	
Semigallia	Zemgale	Latvian	
Lebanon
 Lebanon Lubnān  
English 	Endonym	Notes
	Language
Sidon	Ṣaydā 	Standard Arabic	
Tyre	Ṣūr 	Standard Arabic	
Tripoli	Ṭarābulus 	Standard Arabic	
Libya
 Libya Libiyā  
English 	Endonym	Notes
	Language
Cyrenaica	Barqah 	Standard Arabic	
Fezzan	Fezzan 	Berber	
Fizzān 	Standard Arabic	
Misrata	Miṣrātah 	Standard Arabic	
Sirte	Sirt 	Standard Arabic	
Tripoli	Ṭrables	Berber	
Ṭarābulus 	Standard Arabic	
Ṭrābləs 	Maghrebi Arabic	
Tripolitania	Ṭrables	Berber	
Ṭarābulus 	Standard Arabic	
Ṭrābləs 	Maghrebi Arabic	
Lithuania
 Lithuania Lietuva 
English 	Endonym	Notes
	Language
Neman river	Nemunas	Lithuanian	
Nieman river	Nemunas	Lithuanian	
Samogitia	Žemaitija	Lithuanian	
Sudovia	Sudūva	Lithuanian	
Yotvingia	Dainava	Lithuanian	
Malaysia
 Malaysia 
English 	Endonym	Notes
	Language
Malacca	Melaka	Malay	
Penang Island	Pulau Pinang	Malay	
Johore	Johor	Malay	
Mexico
 Mexico México 
English 	Endonym	Notes
	Language
Kino Bay	Hermosillo	Spanish	
Rocky Point	Puerto Peñasco	Spanish	
Moldova
 Moldova 
English 	Endonym	Notes
	Language
Kishinev	Chişinău	Romanian	Obsolete
Mongolia
 Mongolia Mongγol Ulus  
English 	Endonym	Notes
	Language
Gobi Desert	Govi 	Mongolian	
Ulan Bator	Ulaanbaatar 	Mongolian	Obsolete
Morocco
 Morocco Al-Magrib  
English 	Endonym	Notes
	Language
Casablanca	Ad-Dār Al-Bayḍā' 	Standard Arabic	
Anfa 	Berber	
Fez	Fās 	Berber	
Fās 	Standard Arabic	
Tangier	Ṭanja 	Berber	
Ṭanjah 	Standard Arabic	
Myanmar
 Myanmar Myanma  
English 	Endonym	Notes
	Language
Mekong River	Megaung Myit 	Burmese	
Naypyidaw	Nay Pyi Taw 	Burmese	
Pagan	Bagan 	Burmese	
Rangoon	Yangon 	Burmese	
Ummerapoora	Amarapura 	Burmese	
Nepal
   Nepal Nepāl  
English 	Endonym	Notes
	Language
Mount Everest	Sagarmatha 	Nepali	
Netherlands
 Netherlands Nederland 
English 	Endonym	Notes
	Language
Brill	Brielle	Dutch	Obsolete
Dort	Dordrecht	Dutch	Obsolete
Flushing	Vlissingen	Dutch	Obsolete
Guelders	Gelderland	Dutch	
Leyden	Leiden	Dutch	
Meuse river	Maas	Dutch	 
Rhine river	Rijn	Dutch	
Ryswick	Rijswijk	Dutch	Obsolete
The Hague	Den Haag	Dutch	
Norway
 Norway Noreg Norge 
English 	Endonym	Notes
	Language
Bear Island	Bjørnøya	Norwegian	Translation
North Cape	Davvenjárgga	Northern Sami
Nordkapp	Norwegian
Slagen Valley	Slagndarn	Tunsbergian
Slagendalen	Norwegian
The Southland	Sørlandet
North Korea
 North Korea Chosǒn  
English 	Endonym	Notes
	Language
Diamond Mountain	Kǔmkang-san 	Korean	English now uses rough transliteration Mount Kumgang
Paektu Mountain	Paektu-san 	Korean	
Tumen River	Tuman-kang 	Korean	Mandarin  as the river borders China
Yalu River	Amnok-kang 	Korean	Mandarin  as the river borders China
Palestine
 Palestine Filasṭīn  
English 	Endonym	Notes
	Language
Bethlehem	Beyt Laḥm 	Levantine Arabic	
Bayta Laḥm 	Standard Arabic	
Gaza City	Ġazzah 	Standard Arabic	
Hebron	Al-Ḵalīl 	Standard Arabic	
Jericho	Arīḥā 	Standard Arabic	
Jerusalem	Al-Quds 	Standard Arabic	Latin 
Jordan River	Nahr al-Urdun 	Standard Arabic	
Philippines
 Philippines Pilipinas 
English 	Endonym	Notes
	Language
Caloocan	Kalookan	Tagalog
Cebu	Sugbo	Cebuano
Davao	Dabaw	Cebuano
Manila	Maynila	Tagalog	
Poland
 Poland Polska 
English 	Endonym	Notes
	Language
Auschwitz	Oświęcim	Polish	  
Breslau	Wrocław	Polish	  
Carpathian Mountains	Karpaty	Polish	
Cracow	Kraków	Polish	
Danzig	Gdańsk	Polish	  
Galicia	Galicja	Polish	
Giant Mountains	Karkonosze	Polish	
Kashubia	Kaszëbë	Kashubian	
Kaszuby	Polish	
Kuyavia	Kujawy	Polish	
Mazovia	Mazowsze	Polish	
Mazuria	Mazury	Polish	
Oder river	Odra	Polish	
Pomerania	Pomorze	Polish	
Subcarpathia	Podkarpacie	Polish	
Sudetes Sudeten Sudeten Mountains	Sudety	Polish	
Silesia	Śląsk	Polish	
Ślōnsk	Silesian	
Vistula river	Wisła	Polish	
Warsaw	Warszawa	Polish	
Portugal
 Portugal 
English 	Endonym	Notes
	Language
Azores	Açores	Portuguese	Spanish 
Braganza	Bragança	Portuguese	 Spanish 
Lisbon	Lisboa	Portuguese	
Oporto	Porto	Portuguese	Obsolete
Tagus river	Tejo	Portuguese	Latin 
Romania
 Romania România 
English 	Endonym	Notes
	Language
Bucharest	București	Romanian	
Carpathian Mountains	Carpați	Romanian	
Danube river	Dunǎrea	Romanian	
Jassy	Iași[16]	Romanian	Obsolete
Northern Dobruja	Dobrogea	Romanian	Romanian half of former Dobruja region
Transylvania	Transilvania	Romanian	
Wallachia	Țara Românească Valahia	Romanian	
Russia
 Russia Rossiya  
English 	Endonym	Notes
	Language
Archangel	Arkhangelsk 	Russian	
Black Sea	Chernoje more 	Russian	
Caucasus	Kavkaz 	Russian	
Caspian Sea	Kaspijskoje more 	Russian	
Grozny	Sölƶa-Ġala 	Chechen	
Groznyj 	Russian	
Moscow	Moskva 	Russian	
Orel	Oryol 	Russian	Obsolete
Pacific Ocean	Tikhiy okean 	Russian	
Plescow	Pskov 	Russian	Obsolete
Saint Petersburg	Sankt-Peterburg 	Russian	
Saudi Arabia
 Saudi Arabia As-Sa'ūdīyah  
English 	Endonym	Notes
	Language
Arabian Sea	Al-Baḥr al-'Arabī 	Standard Arabic	
Gulf of Aden	Ḫalīǧ ʻAdan 	Standard Arabic	
Jeddah	Jiddah 	Standard Arabic	
Mecca	Makkah 	Standard Arabic	
Medina	Al-Madīnah 	Standard Arabic	
Riyadh	Er-Riyāḍ 	Najdi Arabic	
Ar-Riyāḍ 	Standard Arabic	
Serbia
 Serbia Srbija  
English 	Endonym	Notes
	Language
Balkan Mountains	Stara Planina 	Serbian	
Belgrade	Beograd 	Serbian	 
Danube river	Dunav 	Serbian	
Slovakia
 Slovakia Slovensko 
English 	Endonym	Notes
	Language
Carpathian Mountains	Karpaty	Slovak	
Cassovia	Košice	Slovak	Latin 
Danube river	Dunaj	Slovak	
Gerlach Peak	Gerlachovský štít	Slovak	
Maple Mountains	Javorníky	Slovak	
Slovak Ore Mountains	Slovenské rudohorie	Slovak	
Slovenia
 Slovenia Slovenija 
English 	Endonym	Notes
	Language
Carinthia	Koroška	Slovene	
Inner Carniola	Notranjska	Slovene	
Karawanks	Karavanke	Slovene	
Karst	Kras	Slovene	
er Carniola	Dolenjska	Slovene	
Slovene Littoral	Primorska	Slovene	
Styria	Štajerska	Slovene	
Upper Carniola	Gorenjska	Slovene	
Somalia
 Somalia Soomaaliya 
English 	Endonym	Notes
	Language
Baidoa	Baydhabo	Somali	
Chisimaio	Kismaayo	Somali	Obsolete
Mogadishu	Muqdisho	Somali	
Villabruzzi	Jowhaar	Somali	
South Africa
Many South African towns have multiple s due to the number of languages. Additionally some places have been red from English and Afrikaans.

 South Africa 
English 	Endonym	Notes
	Language
Aliwal North	Maletswai	Sotho	
Cape Town	ǁHui!gaeb	Khoekhoe	
Kaapstad	Afrikaans	
iKapa	Xhosa	
Fish Hoek	Vishoek	Afrikaans	
Grahamstown	Grahamstad	Afrikaans	 in Afrikaans and English
iRhini	Xhosa	
Makhanda	iRhini	Xhosa	
Queenstown	Komani	Sotho	
Simon's Town	Simonstad	Afrikaans	
South Korea
 South Korea Hanguk  
English 	Endonym	Notes
	Language
Liancourt Rocks	Dokdo 	Korean	
Port Hamilton	Geomundo 	Korean	
Pusan	Busan 	Korean	
Quelpart	Jeju 	Korean	Obsolete
Spain
English uses Spanish-language exonyms for some places in non-Spanish speaking regions of Spain.

 Spain España 
English 	Endonym	Notes
	Language
Andalusia	Andalucía	Spanish	
Basque Country	País Vasco	Spanish	
Euskadi	Basque	
Biscay	Bizkaia	Basque	
Vizcaya	Spanish	
Castile	Castilla	Spanish	
Catalonia	Catalunya	Catalan	Latin 
Corunna	A Coruña	Galician	Obsolete
Douro	Duero	Spanish	Portuguese 
Majorca	Mallorca	Catalan	
Minorca	Menorca	Catalan	
Navarre	Nafarroa	Basque	
Pampeluna	Pamplona	Spanish	
Saragossa	Zaragoza	Spanish	
Seville	Sevilla	Spanish	
Tagus	Tajo	Spanish	Latin 
Teneriffe	Tenerife	Spanish	Obsolete  
The Groyne	A Coruña	Galician	Obsolete
Sri Lanka
Sri Lanka was known as Ceylon in English until 1972.

 Sri Lanka Shri Lanka  
English 	Endonym	Notes
	Language
Adam's Peak	Civaṉoḷipātam 
Civaṉaṭipātam 

Tamil	
Śrī Pāda 	Sinhala	
Batticaloa	Maṭṭakkaḷappu 	Tamil	
Madakalapuwa 	Sinhala	
Chilaw	Cilāpam 	Tamil	
Halawta 	Sinhala	
Colombo	Kolamba 	Sinhala	
Kolumpu 	Tamil	
Delft	Neṭuntīvu 	Tamil	
Ḍelfṭ 	Sinhala	
Galle	Galla 	Sinhala	
Kāli 	Tamil	
Jaffna	Yāḻppāṇam 	Tamil	
Yāpanaya 	Sinhala	
Kandy	Kaṇṭi 	Tamil	
Mahanuwara 	Sinhala	
Kayts	Ūrkāvaṟtuṟai 	Tamil	
Kayiṭs 	Sinhala	
Mutwal	Modara 	Sinhala	
Mukattuvāram 	Tamil	
Negombo	Meegumuwa 	Sinhala	
Nirkolompu 	Tamil	
Point Pedro	Paruttittuṟai 	Tamil	
Pēduru Tuḍuva 	Sinhala	
Trincomalee	Tirukōṇamalai 	Tamil	
Thrikunamalaya 	Sinhala	
Sudan
 Sudan As-Sūdān  
English 	Endonym	Notes
	Language
Khartoum	Al-Ḵurṭūm 	Standard Arabic	
El-Ḵortūm 	Sudanese Arabic	
Nile river	An-Nīl 	Standard Arabic	
En-Nīl 	Sudanese Arabic	
Omdurman	Omm Dormān 	Sudanese Arabic	
Umm Durmān 	Standard Arabic	
Port Sudan	Burtusudan 	Standard Arabic	
Bar'uut	Beja
Sweden
 Sweden Sverige 
English 	Endonym	Notes
	Language
Dalecarlia	Dalarna	Elfdalian	Latin ; Swedish  
Swedish
Gothenburg	Göteborg	Swedish	
North Bothnia	Norrbotten	Swedish	Swedish  
Scania	Skåne	Swedish	Latin 
The Dales	Dalarna	Elfdalian	Obsolete; translation of Swedish 
Swedish
West Bothnia	Västerbotten	Swedish	Swedish  
Switzerland
See also: List of English exonyms for  toponyms
Historically English-language sources borrowed -language s for some places in -speaking Switzerland. This is no longer done and many sources now use  s for most Swiss -speaking places.[17]

 Switzerland Schweiz/ Suisse/ Svizzera/ Svizra 
English 	Endonym	Notes
	Language
Basle	Basel	Standard 	Obsolete
Berne	Bern	Standard 	Obsolete
Geneva	Genève		
Genf	Standard 	
Lucerne	Luzern	Standard 	
Rhine River	Rhein	Standard 	
Valais	Wallis	Standard 	
Syria
 Syria Sūrīyah  
English 	Endonym	Notes
	Language
Aleppo	Ḥalab 	Standard Arabic	
Levantine Arabic	
Damascus	Dimašq 	Standard Arabic	
Dimaš' 	Levantine Arabic	
Euphrates River	Al-Furat 	Standard Arabic	
Homs	Ḥimṣ 	Standard Arabic	
Ḥumṣ 	Levantine Arabic	
Palmyra	Tadmur 	Standard Arabic	
Levantine Arabic	
Latakia	Al-Lāḏiqīyah 	Standard Arabic	
El-Lādi'iyyeh 	Levantine Arabic	
Thailand
Thailand was known as Siam in English until the Siamese revolution of 1932.

 Thailand Prathet Thai  
English 	Endonym	Notes
	Language
Bangkok	Krung Thep 	Thai	Old 
Mekong River	Maenam Khong 	Thai	
Singora	Songkhla 	Thai	Obsolete
Taiwan

This section needs additional citations for verification. Please help improve this article by adding citations to reliable sources in this section. Unsourced material may be challenged and removed. 
The main island of Taiwan is also known in English as Formosa. All Chinese s be are written in traditional characters. As mentioned above in the China section many place s in Taiwan use either pinyin or Wade-Giles.

See also: Chinese language romanization in Taiwan
 Taiwan  
English 	Endonym	Notes
	Language
Pehoe	Phîⁿ-ô͘	Hokkien	
Penghu 	Mandarin	Obsolete from Min Nan  Phênô
Pescadores	Phîⁿ-ô͘	Hokkien	
Penghu 	Mandarin	 Portuguese 
Quemoy	Kimoi	Hokkien	
Kinmen 	Mandarin	Possibly a Spanish or Poruguese transcription of the Zhengzhou Hokkien  for the city Kim-mûi[18]
Tunisia
 Tunisia Tūnis  
English 	Endonym	Notes
	Language
Gabès	Gābes 	Maghrebi Arabic	Pronounced similar to English 
Qābis 	Standard Arabic	
Sfax	Sifaks 	Berber	
Ṣfāqes 	Maghrebi Arabic	
Ṣafaqus 	Standard Arabic	
Sousse	Susa	Berber	
Sūseh 	Maghrebi Arabic	
Sūsah 	Standard Arabic	
Turkey
 Turkey Türkiye 
English 	Endonym	Notes
	Language
Adalia	Antalya	Turkish	
Adrianople	Edirne	Turkish	
Alexandretta	İskenderun	Turkish	
Anemurium	Anamur	Turkish	
Antioch	Antakya	Turkish	
Bosphorus	Boǧaziçi	Turkish	
Byzantium	İstanbul	Turkish	Obsolete
Caeserea	Kayseri	Turkish	
Cappadocia	Kapadokya	Turkish	
Claudiopolis	Mut	Turkish	
Constantinople	İstanbul	Turkish	
Dardanelles	Çanakkale Boǧazı	Turkish	
Edessa	urfa	Turkish	
Ephesus	Efes	Turkish	
Euphrates River	Fırat	Turkish	
Gallipoli	Gelibolu	Turkish	
Halicarnassus	Bodrum	Turkish	
Heraclea Pontica	Karadeniz Ereǧli	Turkish	
Iconium	Konya	Turkish	
Imbros	Gökçeada	Turkish	 
Istanbul	İstanbul	Turkish	Some consider Istanbul to be an English exonym of İstanbul.[19]
Normally spelled without İ in English even in sources which would otherwise use it.[20]

Kerasous	Giresun	Turkish	
Laranda	Karaman	Turkish	
Magnesia ad Sipylum	Manisa	Turkish	
Nicaea	Iznik	Turkish	
Nicomedia	Izmit	Turkish	
Pergamon	Bergama	Turkish	
Philadelphia	Alaşehir	Turkish	
Prusa	Bursa	Turkish	
Scutari	Üsküdar	Turkish	[21]
Seleucia	Silifke	Turkish	
Smyrna	İzmir	Turkish	
Tenedos	Bozcaada	Turkish	 
Thrace	Trakya	Turkish	
Tigris River	Dicle	Turkish	
Tralles	Aydın	Turkish	
Trebizond	Trabzon	Turkish	
Ukraine
 Ukraine Ukrayina  
English 	Endonym	Notes
	Language
Black Sea	Chorne more 	Ukrainian	
Carpathian Ruthenia	Karpatska Rus' 	Ukrainian	Historic region
Carpathian Ukraine	Karpatska Ukrayina 	Ukrainian	Historic region
Chernobyl	Chornobyl 	Ukrainian	Russian 
Crimea	Krym 	Ukrainian	Region claimed by Russia but many nations do not recognize it as part of Russia[22]
Galicia	Halychyna 	Ukrainian	Historic region
Gorlovka	Horlivka 	Ukrainian	 Russian 
Kharkov	Kharkiv 	Ukrainian	 Russian 
Kiev	Kyiv 	Ukrainian	Russian ; though the Russian endonym Kiev prevailed after the Soviet Union ended in 1991 in the late 2010s media outlets and governments began using Kyiv at the request of the Ukrainian government.
Krivoy Rog	Kryvyi Rih 	Ukrainian	 Russian 
Podolia	Podillia 	Ukrainian	Historic region	
Subcarpathia	Pidkarpattia 	Ukrainian	Historic region
Subcarpathian Ruthenia Subcarpathian Rus	Pidkarpatska Rus' 	Ukrainian	Historic region
Transcarpathia	Zakarpattia 	Ukrainian	
Transcarpathian Ukraine	Zakarpatska Ukrayina 	Ukrainian	
Volhynia	Volyn' 	Ukrainian	Historic region
United Kingdom
The places listed are where non-English local languages are mainly used or where the non-English s don't regularly correspond to the English one.

 United Kingdom 
English 	Endonym	Notes
	Language
Aberdovey	Aberdyfi	Welsh	
Abergavenny	Y Fenni	Welsh	
Achmore	An t-Acha Mòr	Scottish Gaelic	
Aird of Sleat	Àird Shlèite	Scottish Gaelic	
Alexandria	Magh Leamhna	Scottish Gaelic	
Ammanford	Rhydaman	Welsh	
Anglesey	Ynys Môn	Welsh	
Applecross	A'Chomraich	Scottish Gaelic	
Ardvasar	Àird a Bhàsair	Scottish Gaelic	
Arinagour	Àirigh na Gobhar	Scottish Gaelic	
Bala Lake	Llyn Tegid	Welsh	
Balivanich	Baile a Mhanaich	Scottish Gaelic	
Ballygrant	Baile a Ghràna	Scottish Gaelic	
Bardsey Island	Ynys Enlli	Welsh	
Barmouth	Abermaw	Welsh	
Barra	Barraigh	Scottish Gaelic	
Barvas	Barabhas	Scottish Gaelic	
Bayble	Pabail	Scottish Gaelic	
Bearsden	Cille Phàdraig Ùr	Scottish Gaelic	Formerly Kilpatrick
Beauly	A'Mhanachainn	Scottish Gaelic	
Beaumaris	Biwmaris	Welsh	
Benbecula	Beinn na Fadhla	Scottish Gaelic	
Bernisdale	Beàrnasdal	Scottish Gaelic	
Bishopbriggs	Coille Dobhair	Scottish Gaelic	Formerly Cadder
Bonvilston	Tresimwn	Welsh	
Borrowstounness 	Ceann an Fhàil	Scottish Gaelic	Formerly Kinneil
Bowmore	Bogh Mòr	Scottish Gaelic	
Bracadale	Bracadal	Scottish Gaelic	
Brecknockshire	Brycheiniog	Welsh	
Brecon	Aberhonddu	Welsh	
Brecon Beacons	Bannau Brycheiniog	Welsh	
Bridgend 	Beul an Àtha	Scottish Gaelic	
Bridgend 	Pen-y-bont ar Ogwr	Welsh	
Breasclete	Breascleit	Scottish Gaelic	
Broadford	An t-Àth Leathann	Scottish Gaelic	
Buckley	Bwcle	Welsh	
Builth Wells	Llanfair-ym-Muallt	Welsh	
Caerleon	Caerllion	Welsh	
Carnavon	Caernarfon	Welsh	
Cairngorms	Am Monadh Ruadh	Scottish Gaelic	
Cairnryan	Machair An Sgithich Cairn Rioghainne	Scottish Gaelic	
Callinish	Calanais	Scottish Gaelic	
Caldey Island	Ynys Bŷr	Welsh	
Calgary	Calgarraidh	Scottish Gaelic	
Camastianavaig	Camas Dìonabhaig	Scottish Gaelic	
Campbeltown	Ceann Loch Chille Chiaran	Scottish Gaelic	
Cardiff	Caerdydd	Welsh	
Cardigan	Aberteifi	Welsh	
Carinish	Càirinis	Scottish Gaelic	
Caray	Càrlabhag	Scottish Gaelic	
Carmarthen	Caerfyddin	Welsh	
Castlebay	Bàgh a Chaisteal	Scottish Gaelic	
Cardiganshire	Ceredigion	Welsh	
Chepstow	Cas-gwent	Welsh	
Chirk	Y Waun	Welsh	
Cleadale	Clèadail	Scottish Gaelic	
Coll	Cola	Scottish Gaelic	
Colonsay	Colbhasa	Scottish Gaelic	
Conway	Conwy	Welsh	
Cowbridge	Y Bont-faen	Welsh	
Craighouse	Taigh na Creige	Scottish Gaelic	
Craignure	Craig an Iobhar	Scottish Gaelic	
Daliburgh	Dalabrog	Scottish Gaelic	
Denbigh	Dinbych	Welsh	
Devil's Bridge	Pontarfynach	Welsh	
Dingwall	Inbhir Pheofharain	Scottish Gaelic	
Dolgelley	Dolgellau	Welsh	
Dufftown	Baile Bhainidh	Scottish Gaelic	
Dunvegan	Dùn Bheagain	Scottish Gaelic	
Ebbw Vale	Glyn Ebwy	Welsh	
Edinbane	An t-Aodann Bàn	Scottish Gaelic	
Eigg	Eige	Scottish Gaelic	
Elgol	Ealaghol	Scottish Gaelic	
Eriskay	Èirisgeigh	Scottish Gaelic	
Fishguard	Abergwaun	Welsh	
Flint	Y Fflint	Welsh	
Ferdale	Am Baile Mòr	Scottish Gaelic	
Fort Augustus	Cille Chuimein	Scottish Gaelic	Formerly Kilwhimin
Fort William	An Gearasdan	Scottish Gaelic	
Fortrose	A' Chananaich	Scottish Gaelic	
Glamorgan	Morgannwg	Welsh	
Goodwick	Wdig	Welsh	
Gower Peninsula	Gŵyr	Welsh	
Great Orme	Y Gogarth	Welsh	
Harlosh	Hèarrlois	Scottish Gaelic	
Harris	Na Hearadh	Scottish Gaelic	
Haverfordwest	Hwlfford	Welsh	
Hawarden	Penarlâg	Welsh	
Hay-on-Wye	Y Gelli Gandryll	Welsh	
Holyhead	Caergybi	Welsh	
Holywell	Treffynnon	Welsh	
Holywood Dumfriesshire	Doire Chonaill	Scottish Gaelic	Formerly Dercongal
Howmore	Tobha Mòr	Scottish Gaelic	
Iona	Ì Chaluim Chille	Scottish Gaelic	
Islay	Ìle	Scottish Gaelic	
Isle of Lewis	Leodhas	Scottish Gaelic	
Isle of Mull	Muile	Scottish Gaelic	
Isle of Skye	Sgitheneach	Scottish Gaelic	
Isleornsay	Eilean Iarmain	Scottish Gaelic	
Jura	Diùra	Scottish Gaelic	
Kincardineshire	A' Mhaorainn	Scottish Gaelic	Sometimes called The Mearns
Knighton	Tref-y-clawdd	Welsh	
Kyleakin	Caol Àcain	Scottish Gaelic	
Kylerhea	Caol Reatha	Scottish Gaelic	
Lampeter	Llanbedr Pont Steffan	Welsh	
Laurencekirk	Coinmheadh	Scottish Gaelic	Formerly Conveth
Laxdale	Lacadal	Scottish Gaelic	
Leurbost	Liùrbost	Scottish Gaelic	
Leverburgh	An t-Òbh	Scottish Gaelic	Formerly Obbe
Linlithgow	Gleann Iucha	Scottish Gaelic	
Llandovery	Llanymddyfri	Welsh	
Llantwit Major	Llanilltud Fawr	Welsh	
Lochboisdale	Loch Baghasdail	Scottish Gaelic	
Lochmaddy	Loch nam Madadh	Scottish Gaelic	
Lochnagar	Beinn Chìochan	Scottish Gaelic	
Menai Bridge	Porthawethwy	Welsh	
Menai Strait	Afon Menai	Welsh	Welsh  
Merionethshire	Meirionydd	Welsh	
Milford Haven	Aberdaugleddau	Welsh	
Milovaig	Miolabhaig	Scottish Gaelic	
Mold	Yr Wyddgrug	Welsh	
Monmouth	Trefynwy	Welsh	
Monmouthshire	Sir Fynwy	Welsh	
Montgomeryshire	Trefaldwyn	Welsh	
Mountain Ash	Aberpennar	Welsh	
Muck	Muc	Scottish Gaelic	
Neath	Castell-nedd	Welsh	
Newbridge	Trecelyn	Welsh	
Newport	Casnewydd	Welsh	
Newtonferry	Port nan Long	Scottish Gaelic	
Newtown	Y Drenewydd	Welsh	
Northop	Llaneurgain	Welsh	
Orsay	Orasaigh	Scottish Gaelic	
Pembrokeshire	Penfro	Welsh	
Pont Neath Vaughan	Pontneddfechan	Welsh	
Port Askaig	Port Asgaig	Scottish Gaelic	
Port Charlotte	Port Sgioba	Scottish Gaelic	
Port Dinorwic	Y Felinheli	Welsh	
Port Ellen	Port Ìlain	Scottish Gaelic	
Port of Ness	Port Nis	Scottish Gaelic	
Portmadoc	Porthmadog	Welsh	
Portnaguran	Port nan Giùran	Scottish Gaelic	
Portnahaven	Port na-hAbhainn	Scottish Gaelic	
Portree	Port Righ	Scottish Gaelic	
Presteigne	Llanadras	Welsh	
Puffin Island	Ynys Seiriol	Welsh	
Raasay	Ratharsair	Scottish Gaelic	
Radnorshire	Maesyfed	Welsh	
Rhondda Cynon Taf	Aberpenna	Welsh	
Rhymney	Rhymni	Welsh	
River Forth	An Abhainn Dubh	Scottish Gaelic	
River Severn	Hafren	Welsh	
River Towy	Afon Tywi	Welsh	
River Usk	Afon Wysg	Welsh	
River Wye	Afon Gwy	Welsh	
Rodel	Roghadal	Scottish Gaelic	
Rothesay	Baile Bhòid	Scottish Gaelic	
Saint Asaph	Llanelwy	Welsh	
Saint David's	Tyddewi	Welsh	
Saint Kilda	Hiort	Scottish Gaelic	Main island called Hirta
Salen	An t-Sàilean	Scottish Gaelic	
Scalpay	Sgalpaigh	Scottish Gaelic	
Scarinish	Sgarainis	Scottish Gaelic	
Scotland	Alba	Scottish Gaelic	
Skigersta	Sgiogarstaigh	Scottish Gaelic	
Snowdon	Yr Wyddfa	Welsh	
Snowdonia	Eryri	Welsh	
Soay	Sòdhaigh	Scottish Gaelic	
South Queensferry	Cas Chaolais	Scottish Gaelic	Formerly Caschillis
Staffa	Stafa	Scottish Gaelic	
Stein	Steinn	Scottish Gaelic	
Stoneybridge	Staoinebrig	Scottish Gaelic	
Stornoway	Steòrnabhagh	Scottish Gaelic	
Swansea	Abertawe	Welsh	
Tain	Baile Dubhthaich	Scottish Gaelic	
Tarbert	Tairbeart	Scottish Gaelic	
Tarskavaig	Tarsgabhaig	Scottish Gaelic	
Tenby	Dynbich-y-pysgod	Welsh	
The Cobbler	Beinn Artair	Scottish Gaelic	Also called Ben Arthur
Tigharry	Taigh a'Gherraidh	Scottish Gaelic	
Tintern	Dindyrn	Welsh	
Tiree	Tiriodh	Scottish Gaelic	
Tobermory	Tobar Mhoire	Scottish Gaelic	
Torrin	Na Torrain	Scottish Gaelic	
Troon	An Truthail	Scottish Gaelic	
Towyn	Tywyn	Welsh	
Uist	Uibhist	Scottish Gaelic	
Ulva	Ulbha	Scottish Gaelic	
Usk	Brynbuga	Welsh	
Vale of Glamorgan	Bro Morgannwg	Welsh	
Vatersay	Bhatarsaigh	Scottish Gaelic	
Wishaw	Camasneachdain	Scottish Gaelic	
Wales	Cymru	Welsh	
Welshpool	Y Trallwng	Welsh	
Whitland	Hendy-gwyn	Welsh	
Wrexham	Wrecsam	Welsh	
United States
Several places in the United States have additional s in various Native languages.

 United States 
English 	Endonym	Notes
	Language
Allegheny River	Ohi:'i:o	Seneca	
Mount McKinley	Denali	Koyukon	See Denali-Mount McKinley naming dispute
Mount Rainier	Tacoma	Salish	
Red House	Joë'hesta	Seneca	
Vietnam
All cities and towns are often spelled without diacritics; s without them are not listed here.

 Vietnam Việt Nam 
English 	Endonym	Notes
	Language
Annamite Range	Dãy Trường Sơn	Vietse	
Black River	Sông Đà	Vietse	
Cholon	Chợ Lớn	Vietse	
Faifo[23]	Hội An	Vietse	Obsolete
Haiphong	Hải Phòng	Vietse	
Ha Long Bay	Vịnh Hạ Long	Vietse	
Hanoi	Hà Nội	Vietse	
Marble Mountains	Ngũ Hành Sơn	Vietse	Vietse  
Mekong River	Sông Mê Kông / Sông Cửu Long	Vietse	
Perfume River	Sông Hương	Vietse	Vietse  
Red River	Sông Hồng	Vietse	
West Lake	Hồ Tây	Vietse	
